AND	AH N D
AND(2)	AE N D
CHROME	K R OW M
CLOSE	K L OW S
CLOSE(2)	K L OW Z
FACEBOOK	F EY S B UH K
GITHUB	JH IH TH AH B
GMAIL	G M EY L
ILLUSTRATOR	IH L AH S T R EY T ER
IN	IH N
MY	M AY
OPEN	OW P AH N
PHOTOSHOP	F OW T OW SH AA P
PLAY	P L EY
POP	P AA P
SEARCH	S ER CH
SIDE	S AY D
SONG	S AO NG
STARE	S T EH R
STOP	S T AA P
SUPERHERO	S UW P ER HH IY R OW
THORN	TH AO R N
YOUTUBE	Y UW T UW B
